######################
############I##  #####
##╫  ####### ###  ####
### T#####I    O   ###
###   ############  ##
##   #            #  #
##   #  T         #  #
###  #            #  #
###   ## ###  ## #   #
####       #  ##     #
###  #######  ###   ##
###O##   ###  ########
###  #   ###  ##   ###
#    #    §   #    ###
#   ## ######## # G###
#  ##  ##         ####
##    O#   ##     ####
###        ##  #######
#######   P###########
##########╫###########
3 254 1 1 2 2