######################
############I##  #####
##∥  ####### ###  ####
### T#####I    O   ###
###   ############  ##
##   #            #  #
##   #  T         #  #
###  #            #  #
###  ### ###  ## ##  #
####       #  ##     #
###  #######  ###   ##
###O##   ###  ########
###  #   ###  ##   ###
#    #    []  #    ###
#   ## ######## # G###
#  ##  ##         ####
##    O#   ##     ####
###        ##  #######
#######   P###########
######################
3 237 1